0000000000000000
0000000110000000
0000011111100000
0001111111111000
0001111111111000
0011111111111100
0011100110011100
0111100110011110
0011111111111100
0011111111111100
0001101111011000
0001110000111000
0000011111100000
0000000110000000
0000000000000000
0000000000000000
0000000000000000
0000000000000000
0000000000000000
0000000000000000