0000000000000000
0000000110000000
0000001111000000
0001111111111000
0001111111111000
0001111111111000
0011111111111100
0111111111111110
0011111111111100
0001111111111000
0001111111111000
0001111111111000
0000001111000000
0000000110000000
0000000000000000
0000000000000000
0000000000000000
0000000000000000
0000000000000000
0000000000000000
